WWWWWWW-WW
W--WWWw-WW
WW-WWWW--W
W--WWW-W-W
W-WWW----W
W--WW-W-WW
WW-WW-W--W
W--WW-WW-W
WW-------W
WWWWWWWWWW